@1
1111111111111111111111111
1000000000000000000000001
1000000000000000000000001
1000000000000000000000001
1110001111111111111000111
1000000000000000000000001
1000000000000000000000001
1000000000000000000000001
1110001111111111111000111
1000000000000000000000001
1000000000000000000000001
1000000000000000000000001
1110001111111111111000111
1000000000000000000000001
1000000000000000000000001
1000000000000000000000001
1000000000011100000000001
1000000000000000000000001
1000000000000000000000001
1000000000000000000000001
@2
1111111111111111111111111
1000000000000000000000001
1000000000000000000000001
1000000000000000000000001
1110001111111111111000111
1000000000000000000000001
1000000000000000000000001
1000000000000000000000001
1110001111111111111000111
1000000000000000000000001
1000000000000000000000001
1000000000000000000000001
1111111111111111000000001
1000000000000000000000001
1000000000000000000000001
1000000000000000000000001
1000000000011111111100001
1000000000000000000000001
1000000000000000000000001
1000000000000000000000001
@
