@0
5
400 300
130 200
60 300
230 120
300 120
1111111111111111111111111
1000000000000000000000001
1000000000000000000000001
1000000000000000000000001
1110000001111111000000111
1000000000000000000000001
1000000000000000000000001
1000000000000000000000001
1000001110000000111000001
1000000000000000000000001
1000000000000000000000001
1000000000000000000000001
1110000001111111000000111
1000000000000000000000001
1000000000000000000000001
1000000000000000000000001
1000000000011100000000001
1000000000000000000000001
1000000000000000000000001
1000000000000000000000001
@1
4
440 260
40 260
40 100
440 100
1111111111111111111111111
1000000000000000000000001
1000000000000000000000001
1000000000000000000000001
1110001111111111111000111
1000000000000000000000001
1000000000000000000000001
1000000000000000000000001
1110001111111111111000111
1000000000000000000000001
1000000000000000000000001
1000000000000000000000001
1110001111111111111000111
1000000000000000000000001
1000000000000000000000001
1000000000000000000000001
1000000000011100000000001
1000000000000000000000001
1000000000000000000000001
1000000000000000000000001
@2
4
400 300
130 200
60 300
230 100
1111111111111111111111111
1000000000000000000000001
1000000000000000000000001
1000000000000000000000001
1110001111111111111000111
1000000000000000000000001
1000000000000000000000001
1000000000000000000000001
1110001111111111111000111
1000000000000000000000001
1000000000000000000000001
1000000000000000000000001
1111111111111111000000001
1000000000000000000000001
1000000000000000000000001
1000000000000000000000001
1000000000011111111100001
1000000000000000000000001
1000000000000000000000001
1000000000000000000000001
@3
4
400 300
130 200
60 300
230 100
1111111111111111111111111
1000000000000000000000001
1000000000000000000000001
1000000000000000000000001
1000000000000000000000001
1000000000000000000000001
1000000000000000000000001
1000000000000000000000001
1000000000000000000000001
1000000000000000000000001
1000000000000000000000001
1000000000000000000000001
1000000000000000000000001
1000000000000000000000001
1000000000000000000000001
1000000000000000000000001
1000000000000000000000001
1000000000000000000000001
1000000000000000000000001
1000000000000000000000001
@4
5
400 300
130 200
60 300
230 100
100 400
1111111111111111111111111
1000000000000000000000001
1000000000000000000000001
1000000000000000000000001
1111111111100001111100001
1000000000000000000000001
1000000000000000000000001
1000000000000000000000001
1000100011111111000000001
1000000000000000000000001
1000000000000000000000001
1000000000000000000000001
1000000000000000000011111
1000000000000000000000001
1000000000000000000000001
1000000000000000000000001
1000000000011111111100001
1000000000000000000000001
1000000000000000000000001
1000000000000000000000001
@5
4
400 300
130 200
60 300
230 100
1111111111111111111111111
1000000000000000000000001
1000000000000000000000001
1110000000000000000000001
1001100000000000000000001
1000011000000000000000001
1000000110000000000000001
1000000001100000000000001
1000000000011000000000001
1000000000000110000000001
1000000000000001100000001
1000000000000000000110001
1000000000000000000001111
1111000000000000000000001
1000000000000000000000001
1000000000000000000000001
1000000111000000000000001
1000000000000000000000001
1000000000000000000000001
1000000000000000000000001
@6
4
400 300
130 200
60 300
230 100
1111111111111111111111111
1000000000000000000000001
1000000000000000000000001
1000000000000000000000001
1111111110000000111110001
1000000000000000000000001
1000000000000000000000001
1000000000000000000000001
1000000011111111000000001
1000000000000000000000001
1000000000000000000000001
1000000000000000000000001
1000011110000000000011111
1000000000000000000000001
1000000000000000000000001
1000000000000000000000001
1000000000011111111100001
1000000000000000000000001
1000000000000000000000001
1000000000000000000000001
@
